PPPPPPPPPPPPPPPPPPPPPPPPPPPPPPPPPPPPPPPPPPPPPPPPPPPPPPPPPPPPPPPP
P                                     E                        P
P                                                              P
P                                    E                         P
P                                                              P
P                                   E                          P
P                                                              P
P                                  E                           P
P                                                              P
P                                 E                            P
P                                                              P
P                                E                             P
P                                                              P
P                               E                              P
P                                                              P
P                              E                               P
P                                                              P
P                             E                                P
P                                                              P
Pe                          E                                 eP
P                                                              P
P                           E                                  P
P                                                              P
PPPPPPPPPPPPPPPPPPPPPPPPPPPPPPPPPPPPPPPPPPPPPPPPPPPPPPPPPPPPPPPP
